border_size=1
usage=map

Xu, Xu, Xu, Re, Uu, Xu, Xu, Xu, Uu^Uf, Re, Uu, Uu, Xu, Xu, Xu, Xu, Xu, Uu, Rr, Rr, Rr, Uu, Xu, Xu
Xu, Xu, Re, Uh, Xu, Xu, Uu, Re^Uf, Re^Uf, Re^Uf, Re, Xu, Xu, Xu, Xu, Xu, Xu, Uh, Uu, Rr, Rr, Uu, Xu, Xu
Xu, Xu, Re, Xu, Re, Re, Uu^Vud, Uu, Uu, Uu, Uu, Rd, Rd, Xu, Xu, Xu, Xu, Xu, Uu, Uu, Uu, Uu, Uu, Xu
Xu, Xu, Uu, Uu^Uf, Uu, Ww, Ww, Ww, Ww, Ww, Ww, Uu^Vu, Uu, Uu^Uf, Uh, Xu, Xu, Xu, Xu, Uu, Rr, Uu, Uu, Xu
Xu, Xu, Uu, Uu, Ww, Ww, Ww, Ww, Ww, Wo, Wo, Ww, Uu^Uf, Uh, Xu, Xu, Xu, Xu, Xu, Uu, Rr, Rr, Uu, Xu
Xu, Xu, Rd, Rd, Uu^Vud, Ww, Ww, Re, Ww, Ww, Ww, Ww, Re, Re^Uf, Uu^Uf, Xu, Xu, Xu, Xu, Xu, Uu, Rr, Uu, Xu
Re^Uf, Re^Uf, Rd, Re, Uu, Rr, Rr, Uu, Rr, 1 Rr, Rr, Uu^Vud, Uu, Uu, Uh, Uh, Xu, Xu, Uh, Xu, Uh, Uu, Uu, Uu
Xu, Xu, Uu^Uf, Uu, Uu, Uu, Ww, Ww, Ww, Ww, Uu, Uu, Re, Xu, Xu, Xu, Xu, Xu, Uh, Uu^Uf, Rr, Rr, Rr, Uu
Xu, Xu, Uu^Uf, Rd, Uu^Vu, Ww, Ww, Wo, Ww, Uu^Vud, Rd, Re, Uu, Xu, Uu, Xu, Uu, Xu, Rr, Uu, Uu, Rr, Uu, Rr
Xu, Xu, Rd, Re, Uu, Ww, Rd, Ww, Uu, Uu, Re, Rd, Uu, Rd, Rd, Uu, Rr, Rr, Rr, Uu, Uu, Rr, Uu, Uu
Xu, Xu, Uu, Re, Re, Uu, Rd, Re, Re, Rd, Uu^Uf, Rd, Xu, Rd, Uu, Uu, Uu, Uu, Xu, Uu, Uu, Uu, Uu, Uu
Xu, Xu, Xu, Uu^Vud, Xu, Rd, Re, Uu^Vud, Xu, Uu^Uf, Xu, Xu, Xu, Xu, Xu, Xu, Xu, Xu, Xu, Xu, Uu, Rr, Rr, Uu
Xu, Xu, Xu, Xu, Xu, Xu, Xu, Xu, Xu, Xu, Xu, Xu, Xu, Xu, Xu, Xu, Xu, Xu, Xu, Xu, Uu, Rr, Rr, Uu
