border_size=1
usage=map

Ww, Ww, Ww, Ww, Gg, Gs^Fp, Gg, Gg, Gg, Gg, Gs^Fp, Gg, Gg, Gs^Fp, Gg, Gg, Gg, Aa, Gg^Fp, Gg, Gg, Gg
Ww, Ww, Ww, Gg^Vh, Gg, Gs^Fp, Gs^Fp, Gs^Fp, Gs^Fp, Gs^Fp, Gs^Fp, Gg, Gg, Gg, Gg, Gg, Gg^Fp, Gg^Fp, Gg, Gg, Gg^Vh, Gg
Ww, Ww, Ww, Hh, Gg, Gg, Gg, Gs^Fp, Gs^Fp, Gs^Fp, Gg, Gg, Gg, Gg, Gg^Fp, Gg^Fp, Gg, Gg, Gg, Gg, Gg, Gg
Ww, Ww, Ww, Ww, Gg, Gg, Gg, Gg, Gg, Gg, Gg, Gg, Gg, Gg, Gg, Gg, Gg^Vh, Gg, Gg, Gg, Gg^Fp, Gg
Ww, Ww, Ww, Hh, Gs^Fp, Gg, Gg, Gg, Gg, Gg, Gg, Gg, Gg, Gg, Gg, Gg, Gg, Gg, Gg, Gg, Gg, Gg
Ww, Ww, Ww, Gg, Gs^Fp, Gg, Gg, Gg^Fp, Gg^Fp, Gg^Fp, Gg^Fp, Gg^Fp, Gg^Fp, Gg, Gg, Co, Co, Co, Gg, Gg, Gg, Gg
Ww, Ww, Ww, Gg, Gs^Fp, Gg, Gg, Hh^Fp, Gg^Fp, Gg, Gg, Gg, Gg, Gg, Gg, Co, Co, 2 Ko, Gg, Gg, Gg, Gg
Ww, Hh, Ww, Gg, Gs^Fp, Gg, Gg, Hh^Fp, Hh, Hh, Hh, Hh, Gg^Vh, Gg, Gg, Gs^Fp, Gs^Fp, Gs^Fp, Gg, Gg, Gg, Gg
Gg, Gg, Ww, Gg^Vh, Gs^Fp, Gg, Gg, Hh, Mm, Mm, Hh, Hh, Ww, Ww, Ww, Ww, Ww, Gg, Gg, Gg, Gg, Gg
Gs^Fp, Gs^Fp, Ww, Ww, Gg, Hh, Hh, Mm, Ww, Ww, Ww, Ww, Ww, Ww, Ww, Ww, Gg^Vh, Gg, Gg, Gll^Fp, Gg, Gg
