border_size=1
usage=map

Wwt, Wwt, Wwt, Wwt, Dd, Dd, Wwt, Wwt, Wwt, Wwt, Wwt, Wwt, Wwt, Wwt, Wwt, Wwrt, Wwt, Wwf, Wwf, Wwf, Wwt, Wwt, Wwt
Wwt, Wwt, Wwt, Wwt, Wwt, Wwf, Wwf, Wwf, Wwt, Wwt, Wwt, Wwt, Wwt, Wwt, Wwt, Wwrt, Wwrt, Wwrt, Wwrt, Wwt, Wwt, Wwt, Wwt
Wwf, Wwf, Wwt, Wwt, Wwt, Wwf, Wwf, Wwrt, Wwt, Wwt, Ww^Vm, Wwt, Ww^Vm, Wwt, Wwt, Wwf, Wwrt, Wwt, Wwrt, Ds, Wwt, Wwt, Ww^Vm
Wwt, Wwt, Wwt, Wwt, Wwt, Wwt, Wwrt, Wwrt, Wwt, Wwt, Wwt, Wwt, Wwt, Wwt, Wwt, Wwf, Wwt, Wwt, Wwt, Ds, Ds, Wwt, Wwf
Wwt, Ds, Wwf, Wwf, Wwt, Wwt, Wwrt, Wwt, Wwt, Ds, Ds, Wwt, Wwt, Wwt, Wwt, Wwf, Wwf, Wwf, Wwf, Wwt, Wwt, Wwt, Wwt
Ds, Ds, Wwf, Wwf, Wwf, Ww^Vm, Wwt, Ds, Ds, Chw, Chw, 2 Khw, Chw, Chw, Wwt, Wwt, Mm, Ww^Vm, Wwt, Wwt, Wwt, Wwt, Wwt
Wwt, Wwt, Wwf, Wwt, Wwt, Wwt, Wwt, Wwt, Ds, Ds, Chw, Wwt, Chw, Wwt, Wwt, Wwt, Wwt, Wwt, Wwt, Wwt, Wwt, Wwt, Wwt
Wwt, Wwt, Wwt, Wwt, Wwt, Wwt, Wwt, Wwt, Wwt, Ds, Ds, Ds, Wwt, Wwt, Wwt, Wwt, Wwt, Wwt, Wwt, Wwt, Wwt, Wwt, Wwt
Wwt, Wwt, Wwt, Wwt, Wwt, Wwt, Wwt, Wwt, Wwt, Wwt, Wwt, Wwt, Wwt, Wwt, Wwt, Wwt, Wwt, Wwrt, Wwt, Wwt, Wwt, Wwf, Wwf
Wwt, Wwt, Wwt, Wwrt, Wwrt, Wwrt, Wwt, Wwt, Wwt, Wwt, Ww^Vm, Wwt, Ww^Vm, Wwt, Wwt, Wwrt, Wwrt, Wwrt, Wwrt, Wwrt, Wwf, Wwf, Ww
Wwt, Wwt, Wwt, Wwt, Wwrt, Wwt, Wwt, Wwt, Wwt, Wwf, Wwf, Wwf, Wwt, Wwt, Wwt, Wwt, Wwt, Wwt, Wwf, Wwf, Wwf, Ww, Wwf
Wwt, Wwt, Wwt, Wwrt, Wwrt, Wwrt, Wwrt, Wwf, Wwf, Wwt, Wwt, Wwt, Wwt, Wwt, Wwt, Wwt, Wwt, Wwf, Wwt, Wwf, Wwf, Wwf, Ss
Ww^Vm, Wwt, Wwt, Wwt, Wwrt, Wwt, Wwt, Wwt, Wwf, Wwt, Wwt, Wwt, Ds, Ds^Es, Ds, Wwt, Wwf, Wwf, Wwf, Wwf, Wwf, Wwf, Wwt
