border_size=1
usage=map

Xu, Re, Uu, Uu, Uu, Uu^Ii, Uu^Ii, Re, Re, Re^Ii, Re^Ii, Uu^Ii, Uh, Re, Xu, Xu, Xu, Xu, Urb, Xu, Xu, Xu, Xu, Xu
Xu, Re, Cud, Cud, Cud, Re^Ii, Re^Ii, Re, Re, Uu, Uu, Uu, Re, Xu, Xu, Xu, Xu, Urb, Urb, Urb, Xu, Xu, Xu, Xu
Uu, Uu, Re, Kud, Cud, Re^Ii, Uu^Vud, Re, Uu, Uu, Uu, Re, Urb^Ii, Re^Ii, Re^Ii, Uu, Uu, Xu, Re, Xu, Xu, Xu, Xu, Xu
Xu, Uu, Re, Re, Re, Uu, Uu, Uu, Uu, 1 Uu, Urb, Urb, Urb^Ii, Urb^Ii, Urb^Ii, Uu, Uu, Uu, Re, Uu, Xu, Xu, Xu, Xu
Xu, Xu, Xu, Xu, Uu, Uu, Uu, Re, Urb, Urb, Urb, Urb, Urb, Urb^Ii, Co, Uu, Urb, Re, Re, Uu, Xu, Xu, Xu, Xu
Urb^Edt, Xu, Xu, Xu, Uu, Uu, Uu, Re, Re^Ii, Urb^Ii, Urb^Ii, Urb, Urb, Co, 2 Ko, Uu^Vu, Urb, Urb, Urb, Uu, Xu, Xu, Uu, Uu
Urb^Edt, Xu, Xu, Xu, Re, Uu, Re, Uu, Uu^Ii, Re^Ii, Uu^Ii, Urb, Urb, Co, Co, Co, Urb, Urb, Re, Uu, Xu, Xu, Uu, Uu
Uu, Xu, Xu, Xu, Re, Re, Xu, Xu, Xu, Uu^Ii, Uu^Vud, Uu, Uu, Urb, Urb, Urb, Re, Re, Xu, Uu^Vud, Xu, Xu, Uu, Uu
Uu, Uu, Re, Re, Re, Uu, Xu, Xu, Xu, Xu, Xu, Re, Uu, Uu, Re, Uu, Uu, Re, Xu, Xu, Xu, Xu, Uu, Uu
Uh, Uu, Uu, Re, Xu, Uu, Uu^Vu, Xu, Xu, Xu, Xu, Re, Uu, Uu, Xu, Uu, Uu, Uu, Re, Xu, Uu, Uu, Uu, Uu
Xu, Xu, Xu, Xu, Xu, Uu^Uf, Uu, Uu, Uu, Xu, Uu, Uu, Uu, Re, Xu, Uu, Uu, Uu, Uu, Uu, Uu, Uu, Uu, Uh
Xu, Xu, Xu, Xu, Uu^Em, Uu^Em, Uu^Em, Xu, Xu, Uu, Re, Re, Uu, Xu, Xu, Xu, Xu, Uu, Uu, Uu, Uu, Uu, Uh, Uh
Re, Re, Re, Re, Uu, Uu^Em, Xu, Xu, Xu, Xu, Xu, Re, Uu, Xu, Xu, Xu, Xu, Xu, Xu, Uu, Uh, Uh, Uh, Uh
