Gs, Gll^Fp, Gll^Fp, Gs, Gs, Gs, Gs, Gs, Gs, Gs, Gs^Fp, Gll^Fp, Gs, Gs, Gg, Gg, Gg, Wo, Wo, Gg, Gg, Gs, Gs, Gs
Gs, Gs, Gs, Gs^Fp, Gs, Gs, Gs, Gs, Gs, Gs, Gs, Hh, Gs, Gs, Gg, Gg, Gg, Wo, Wo, Gg, Gs, Gs, Re, Re
Gs, Gs, Gs, Gll^Fp, Gll^Fp, Gs, Gs, Gs, Gs, Gs, Hh, Hh, Gs, Gs, Gg, Gg, Gg, Wo, Wo, Gg, Re, Gs, Gs, Gs
Gs, Gs, Gs, Gs, Gs^Fp, Gs, Gs, Gs, Gs, Gs, Gs, Hh^Vhh, Gs, Gs, Gs, Gg, Gg, Wo, Wo^Bsb/, Re, Gs, Gs, Gs, Gs
Gs, Gs, Gs, Gs^Fp, Gs^Vl, Gs, Gs, Gs, Gs, Gs, Rr, Rr, Rr, Gs, Gs, Gg, Rr, Wo^Bsb/, Chw, Re, Gs, Gs, Gs, Gs
Gs, Gs, Gs, Gs^Fp, Hh, Gs, Gs, Gs, Rr, Rr, Hh, Hh, 1 Hh, Rr, Rr, Rr, Gg, Chw, 2 Khw, Chw, Re, Gs, Hh, Gs
Hh, Gs, Gs, Gs, Hh, Hh, Rr, Gs, Gs, Gs, Hh, Hh, Hh, Gg, Gg, Gg, Gg, Chw, Chw, Chw, Gs, Gs, Hh, Hh
Gs, Gs, Rr, Gs, Rr, Rr, Gs, Gs, Gs, Gs, Gs, Hh, Hh, Hh, Gg, Gg, Wo, Wo, Wo, Gg, Gs, Gs, Hh, Hh
Rr, Rr, Gs, Rr, Gs, Gs, Gll^Fp, Gs, Gs, Gs, Gs, Gg, Gg, Ss, Gg, Gg, Wo, Wo, Gg^Fp, Gg, Gll^Fp, Gs, Gs, Gs
Gs, Gs, Gs, Gs, Gll^Fp, Gll^Fp, Gll^Fp, Gll^Fp, Gs, Gs, Gs, Gg, Gg, Ss, Ss, Ss, Wo, Wo, Gg^Fp, Gll^Fp, Gll^Fp, Gll^Fp, Gs, Gs
Gs, Gs, Gs, Gs, Gs^Vc, Gs, Gll^Fp, Gs, Gs, Gs, Gs, Gs, Gg, Ss, Wo, Wo, Wo, Wo, Gg, Gg, Gs, Gs, Gs, Gs
Gs, Gs, Gs, Gs, Gs, Gs, Gll^Fp, Gs, Gs, Gs, Gs, Gg, Gg, Wo, Wo, Wo, Ss, Gg, Gg, Gs, Gs, Gs, Hh, Gs
Gs, Gs, Gs, Gs, Gs, Gs, Gs, Gll^Fp, Gs, Gs, Gll^Fp, Gll^Fp, Gg^Fp, Wo, Wo, Ss, Gg, Gg, Gg, Gs, Gs, Gs, Hh, Hh
